01111000
11111111
11111111
11100111
11111111
11111110
11111100
00011110